NO     ./asset/texture/church_window.xpm

WE    ./asset/texture/black_brick.xpm

SO    ./asset/texture/window_view.xpm

EA    ./asset/texture/BRICK.xpm

P      ./asset/texture/porte.xpm

O      ./asset/texture/porte_close.xpm

C 8,    150,    255


F 115   ,100 ,  100


                1111111111111111111111111
                1000000000110000000000001
                101100000111000001000000111111111
                100100000000000010000000000000001
        11111111111000001110000000000001011111101
        100000000011000001110111111111111     101
        11110111111111011100000010001      111101111
        11110111111111011101010010001      100000001
        11000000110101011100000010001      1000N0001
1111111110000000100000000000000000001      111111111
100000000000000000000000000101001000111
11111111110000010101010101101111000111
        11110111P10101010101000000001
        111111110111111101P1111111111
        111111100000000000000000001
        11111111111111111111111111111
1111111111111111111111111111111111111
        11111111111101010101010110111
        10000000001100000000000000001
        101100000111000001000000111111111
        100100000000000010000000000000001
11111111111000001110000000000001111111101
10000000001100000111011111P111111     1P1
111101111111110111000000100011111111111001111
11110111111111011101010010000000000000000001
11000000110101011100000010000000000000000001
10000000000000000000000000001111111111111111
1100000111010101111101111000111
11110111 1110101 10100000000001
11111111 1111111 1111111111111
11111111111111111111111111111111
