NO ./asset/texture/church_window.xpm


WE        ./asset/texture/black_brick.xpm


SO    ./asset/texture/window_view.xpm


EA  ./asset/texture/BRICK.xpm


F 115   ,109,  100

C 8, 150,    255


                                           111
                                           101
                1111111111111111111111111  101
                1000000000110000000000001  101 
                101100000111000001000111111101111
                100100000000001000000000000000001
        111111111110000011100000000E0001011111101
        100000000011000001110111111111111     101
        11110111111111011100000010001      111101111
        11110111111111011101010010001      100000001
        11000000110101011100100010001      100000001
1111111110000000100000000000000000001      111111111
100000000000000000000100000101001000111
11111111110000010101010101101111000111
        11110111010101010101000000001
        11111111111111111111111111111
                                           111
                                           101
                1111111111111111111111111  101
                1000000000110000000000001  101 
                101100000111000001000111111101111
                100100000000001000000000000000001
        11111111111000001110000000000001011111101
        100000000011000001110111111111111     101
        11110111111111011100000010001      111101111
        11110111111111011101010010001      100000001
        11000000110101011100100010001      100000001
1111111110000000100000000000000000001      111111111
100000000000000000000100000101001000111
11111111110000010101010101101111000111
        11110111010101010101000000001
        11111111111111111111111111111
