NO    ./debug/texture/new_2.xpm


WE    ./debug/texture/new_4.xpm



SO    ./debug/texture/new_3.xpm


EA    ./debug/texture/new_4.xpm


F 115   ,100,  100
C 8,    150,    255



11111111
100000011111
100N00000001
100000011111
11111111