NO    ./debug/texture/NETHER.xpm


WE    ./debug/texture/SANDSTONE.xpm



SO    ./debug/texture/BRICK.xpm


EA    ./debug/texture/COBLE.xpm


F 115   ,100,  100
C 8,    150,    255
     

        1111111111111111111111111
        1000000000110000000000001
        101100000111000001000000111111111
        100100000000000010000000000000001
11111111111000001110000000000001111111101
1000S0000011000001110111111111111     101
11110111111111011100000010001      111001111
11110111111111011101010010001      100000001
11000000110101011100000010001      100000001
10000000000000001100000000001      111111111
1000000000000000110101001000111
1100000111010101111101111000111
11110111 1110101 101111010001
11111111 1111111 111111111111

